++++++++++++++++++++++
+                    +
                     +
+                    +
+                    +
+                    +
+                    +
+                    +
+                    +
+               S    +
++++++++++++++++++++++