+++++++++++++++++++++++++++++++++++++++++
+   +         +           +             +
  + + +++++++ +++++ +++++ +++++++++++++ +
+ + + +           +     +     +       + +
+ + +++ +++++++++ + +++ +++ +++ + + + + +
+ +     +       + +   +   +     + + + + +
+ +++ +++++++ +++ +++++ + + +++ + + + + +
+   + +     + +   +     + + + + + +   + +
+ +++ +++++ + + +++ +++ +++ + +++ +++ + +
+ +       + + + +   +     + +   +   + + +
+ + +++++ + + + + + +++ +++++ + + + +++ +
+ + +   + +   + + +     +     + + +     +
+ + + +++ +++ +++ + +++ +++ + +++ + +++ +
+ + + +           + + +   + +       + + +
+ +++ +++++++++++ +++ +++++ +++ + +++ + +
+ +             + +      S    + + + + + +
+ +++ +++ +++++ + +++++++ +++++ +++ + + +
+   + + +   +   +       + +         +   +
+ +++ + +++++ +++++++++ +++ +++++++++++ +
+ +                                   + +
+++++++++++++++++++++++++++++++++++++++++
